TST = "countries/Test.txt"
ALI = "countries/Alinek.txt"
FRE = "countries/Freedowia.txt"
ATF = "countries/At Fistran.txt"
AAC = "countries/Aachenania.txt"
PRT = "countries/Partiria.txt"
VRA = "countries/Varadinum.txt"
TIA = "countries/Tiandengxi.txt"
KHR = "countries/Khrista.txt"
MOS = "countries/Mosau.txt"
KUN = "countries/Kunesi.txt"
IGE = "countries/Igel-Velten.txt"
TRK = "countries/Tricklandia.txt"
ROS = "countries/Roskau.txt"
LON = "countries/Londoria.txt"
FAR = "countries/Far Moodaken.txt"
WEL = "countries/Welveion.txt"
ERS = "countries/Erisanko.txt"
HAJ = "countries/Hajol.txt"
NIO = "countries/Niomenia.txt"
CYR = "countries/Cyrasa.txt"
BUG = "countries/Burgess.txt"
WCS = "countries/Spacostan.txt"
RST = "countries/Restora.txt"
SOF = "countries/Souf.txt"
BAL = "countries/Baller State.txt"
NRT = "countries/Northernia.txt"
SAN = "countries/Saunel.txt"
CYI = "countries/Cyriun.txt"
ENF = "countries/Enfferson.txt"
MDI = "countries/Maditiation.txt"
VIB = "countries/Vibonia.txt"
VIT = "countries/Vitfin.txt"
TOM = "countries/Tommajo.txt"
LOT = "countries/Lothric Anor.txt"
LYC = "countries/Lycenia.txt"
AUT = "countries/Austil.txt"
MUL = "countries/Mulashilame.txt"
OBE = "countries/Oberlosk.txt"
LAN = "countries/Langfaran.txt"
VIP = "countries/Vipru.txt"
SPF = "countries/Soupref.txt"
ASR = "countries/Astroika.txt"
BYT = "countries/Bytswana.txt"
CNB = "countries/Cinberia.txt"
AVA = "countries/Avalon.txt"
MIC = "countries/Mich.txt"
TNI = "countries/Tuninstan.txt"
ASC = "countries/Aschinge.txt"
GRM = "countries/Germainari.txt"
POY = "countries/Polypotamia.txt"
APA = "countries/Apacina.txt"
LLI = "countries/Lliaachistan.txt"
RED = "countries/Redbrook.txt"
MAU = "countries/Maubilia.txt"
HJO = "countries/Hjoland.txt"
STE = "countries/Steoji.txt"
FOR = "countries/Forstration.txt"
TRW = "countries/Transekwonia.txt"
DER = "countries/Deralia.txt"
KVY = "countries/Kvylia.txt"
HNG = "countries/Hangulan.txt"
CYN = "countries/Cyinto.txt"
MAQ = "countries/Maqwar.txt"
AYR = "countries/Ayra.txt"
MAK = "countries/Makeeb.txt"
RYZ = "countries/Ryzania.txt"
DIC = "countries/Dicremos.txt"
SEC = "countries/Secampora.txt"
CHD = "countries/Chudia.txt"
USI = "countries/Usiyera.txt"
NAT = "countries/Natrestu.txt"
PLK = "countries/Policka.txt"
RET = "countries/Retula.txt"
DOW = "countries/Downsday.txt"
HDD = "countries/Haid Dab.txt"
CRK = "countries/Cork Islands.txt"
LAK = "countries/Lakmunistan.txt"
KER = "countries/Kerblice.txt"
BER = "countries/Berenice.txt"
CIA = "countries/Ciarach.txt"
EQU = "countries/Equitasia.txt"
APU = "countries/Aput.txt"
ZAP = "countries/Zaporanos.txt"
SYL = "countries/Sylvania.txt"
DUC = "countries/Duchistorca.txt"
HTH = "countries/Hethmara.txt"
PEL = "countries/Pelisipia.txt"
AFR = "countries/Afrstan.txt"
AMP = "countries/Amperslandia.txt"
FRO = "countries/Feroncia.txt"
CHN = "countries/Chinosinst.txt"
JMH = "countries/Jamhuria.txt"
ASS = "countries/Assenisipia.txt"
HIR = "countries/Hirehiy.txt"
AKI = "countries/Aki Iki.txt"
CRE = "countries/Creteos.txt"
ESS = "countries/ESSLIB PLC.txt"
TRO = "countries/Tropaepaata.txt"
CNF = "countries/New Frontier.txt"
TGF = "countries/Green Frontier.txt"
ORT = "countries/Ortaria.txt"
IBA = "countries/Ibarthelastorosa.txt"
SCV = "countries/Scovia.txt"
ESH = "countries/Esherium.txt"